MMMMMMMMMMMMMMMMMMMMMMMMMMMMMMMM
MTRVTTTTTRTTTTTTTTTTTTTTTTTTTTTM
MTTTTPTRTTTRTTTRTTTTTRTTTTTTRTTM
MTTTRTTTTTRTTTTDTTRTTDTRTTTRTTTM
MTTTTTTRTTTTRTTTTTTTTTTTTTTTTTTM
MMMMMMMMMMMMMMMMMMMMMMMMMMMTRTTM
MTTTRTRTTTTTTTRTTTTTTTTRTTTTTTTM
MTTTDTTTTTRTTTTTRTTTRTTTRTTTRTTM
MTTRRTTTTTTTTTTTTTTTTTTTTTTTTTTM
MTTTTTTMMMMMMMMMMMMMMMMMMMMMMMMM
MTTTTTTTRTTTRTTTRTTTTTTTTTTTTTTM
MTTTTTRTDRTTTTRTTTTTTTRTTRRTTTTM
MTTRTRTTTTTRTTTTTTRTTTTTTDTTTTTM
MTTDTTTTRTTTTTTDTTTRTRTTTTTRTTTM
MTTTTTTTTTTTTTTTTTTTTTTTTTTTTTTM
MMMMMMMMMMMMMMMMMMMMMMMMMMMMMMMM