MMMMMMMMMMMMMMMMMMMMMMMMMMMMMMMM
MTRVTTTTTTTTTTTTTTTTTTTTTTTTTTTM
MTTTTPTTTTTTTTTTTTTTTTTTTTTTRTTM
MTTTTTTTTTTTTTTTTTRTTTTTTTTRRTTM
MTTTTTTTTTTTRTTTTTTTTTTTTTTTRTTM
MTTTTTTTRTTTTTTTTTTTTTTTMTTTRTTM
MTTTTTTTTTTTTTRTTTTTTTTTMTTTTTTM
MTTTTTTTTTTTTTTTTTTTTTTTMTTTTTTM
MTTTTTTTTTTTTTTTTMMMMMMMMTTTTTTM
MTTTTTTTTTTTTTTTTTTTTTTTMTTTTTTM
MTTTTTTTDTTTTTTTTTTTTTTTMTTTTTTM
MTTTTTTTTTTTTTTTTTTVTTTTMTTTTTTM
MTTTTTTTTTTTTTTTTTTTTTTTTTTTTTTM
MTTTTTTTTTTTTTTDTTTTTTTTTTTTTTTM
MTTTTTTTTTTTTTTTTTTTTTTTTTTTTTTM
MMMMMMMMMMMMMMMMMMMMMMMMMMMMMMMM