MMMMMMMMMMMMMMMMMMMMMMMMMMMMMMMM
MTRVTTTTTRTTTTTTTTTTTTTTTTTTTTTM
MTTTTPTRTTTRTTTRTTTTTTTTTTTTRTTM
MTTTTTTTTTRTTTTTTTRTTTTTTTTRRTTM
MTTTTTTRTTTTRTTTTTTTTTTTTTTTRTTM
MMMMMMMMMMMMMMMMMMMMMMMMMMMTRTTM
MTTTTTRTTTTTTTRTTTTTTTTRTTTTTTTM
MTTTTTTTTTRTTTTTRTTTRTTTTTTTRTTM
MTTRTTTTTTTTTTTTTTTTTTTTTRTTTTTM
MTTTTTTMMMMMMMMMMMMMMMMMMMMMMMMM
MTTTTTTTDTTTRTTTRTTTTTTTTRTTTTTM
MTTTTTRTTTTTTTRTTTTVTTRTTRRTTTTM
MTTRTTTTTTTRTTTTTTRTTRTTTDTTTTTM
MTTTTTTTRTTTTTTDTTTRTTTTTDTTTTTM
MTTTTTTTTTTTTTTTTTTTTTTTTTTTTTTM
MMMMMMMMMMMMMMMMMMMMMMMMMMMMMMMM