MMMMMMMMMMMMMMMMMMMMMMMMMMMMMMMM
MRMTTTTTTRTTTRTTTTRTTTMRTTTTTTTM
MTMTTPTRTTTRTTTRTTTTTTMDRTTTRTTM
MTTRTMTTTTRTTMTDTTRTTRMTTTTRTTTM
MTTTTMTRTTTTRMTTTTTTTTTTTTTTTTTM
MMMMMMMMMMMMMMMMMMMMMMMMMMMTRTTM
MTRRTTRTTTTTTTRTTRTTTTTRTTMRTRTM
MTTDTTTRTTRTTMTTRDTTRTTTTTTTRTTM
MTTTTRTTTTTTTMTTTTTTTTTTTRTTTTTM
MTTTRTTMMMMMMMMMMMMMMMMMMMMMMMMM
MTTRTTTTDTTTRTTTRTTTTTTTTRTTTTTM
MTTTTTRTTTTTTTRTTTTTTTRTTRRTTTTM
MTTRTTTTTTTRTTTTTTRTTRTTTDTTTRTM
MTTDRTTTRTTMTTTDTTTRTTTTTTTTMDTM
MTTTTTTTTTTMTTTTTTTTTTTTTTTTMTTM
MMMMMMMMMMMMMMMMMMMMMMMMMMMMMMMM