MMMMMMMMMMMMMMMMMMMMMMMMMMMMMMMM
MDRTTTTTTTTTTTTTTTTTTTTTTTTTTTTM
MTTTTPTTTTTRTTTTTTTTTTRDTTTTRTTM
MTTTTTRTTTTTTTTTTTRTTTTTTTTRTTTM
MTTTTTTTTTTTRTTTTTTTTTRTTTTTTTTM
MTTTRTTTRTTTTTTTTTTTTRTTTTTTRTTM
MTTTTTTTTTTTTTRTTTTTTTTTTTTTDTTM
MMMMMMMMMMMMMMMMMMMMTTTTTTTTTTTM
MTTTTTTTTTTTTTTTTTTTTTTTTTTRTTTM
MTTTTRTTTTTTTTTTTTTRTTTTRTTTTTTM
MTTTTTTTDTTTTTTRTTTTTTTTTTTTTTTM
MTTTTTTTTTTTTTTTTTTRTTTTRTTTTTTM
MTTTTTTTTRTTTTTTRTTTTTTTTTTRTTTM
MTTTTTRTTTRTTTTDTTTTTTTTRTTTTTTM
MTTTTTTTTTTTTTTTTTTTTTTTTTTTTTTM
MMMMMMMMMMMMMMMMMMMMMMMMMMMMMMMM