MMMMMMMMMMMMMMMMMMMMMMMMMMMMMMMM
MDRTTTTTTTTTTTTTTTTTTTTTTTTTTTTM
MTTTTTTTTTTRTTTTTTTTTTRDTTTTRTTM
MTTTTTRTTTTTTTTTTTRTTTTTTTTRTTTM
MTTTTTTTTTTTRTTTTTTTTTRTTTTTTTTM
MTTTRTTTRTTTTTTTTTTTTRTTTTTTRTTM
MTTTTTTTTTTTTTRTTTTTTTTTTTTTDTTM
MMMMMMMMMMMMMMMMMMMMTTTTTTTTTTTM
MTTTTTTTTTTTTTTTTTTTTTTTTTTRTTTM
MTTTTRTTTTTTTTTTTTTRTTTTRTTTTTTM
MTTTTTTTDTTTTTTRTTTTTTTTTTTTTTTM
MTTTTTTTTTTTTTTTTTRTTTTRTTTRTTTM
MTTTTTTTTRTTTPTRTTTTTTTTTTTRTTTM
MTTTTTRTTTRTTTTDTTTTTTTTRTTTTTTM
MTTTTTTTTTTTTTTTTTTTTTTTTTTTTTTM
MMMMMMMMMMMMMMMMMMMMMMMMMMMMMMMM