MMMMMMMMMMMMMMMMMMMMMMMMMMMMMMMM
MRMTTTTTTRTTTRTTTTRTTTMRTTTTTTTM
MTMTTPTRTTTRTTTRTTTTTTMDRTTTRTTM
MTTRTMTTTTRTTMTDTTRTTRMTTTTRTTTM
MTTTTMTRTTTTRMTTTTTTTTTTTTTTTTTM
MMMMMMMMMMMMMMMMMMMMMMMMMMMTRTTM
MTRRTTRTTTTTTTRTTRTTTTTRTTMRTRTM
MTTDTTTRTTRTTMTTRDTTRTTTTTTTRTTM
MTTTTRTTTTTTTMTTTTTTTTTTTRTTTTTM
MTTTRTTTTTTTTTTTTTTTTTTTTTTMMMMM
MTTRTTTTDTTTRTTTRTTTTTTTTRTTTTTM
MTTTTTRTTTTTTMRTTTTTTTRTTRRTTTTM
MTTRTTTTTTTRTMTTTTRTTRTTTDTTTRTM
MTTDRTTTRTTMMMTDTTTRTTTTTTTTMDTM
MTTTTTTTTTTMTTTTTTTTTTTTTTTTTTTM
MMMMMMMMMMMMMMMMMMMMMMMMMMMMMMMM