MMMMMMMMMMMMMMMMMMMMMMMMMMMMMMMM
MTRVTTTTTTTTTTTTTTTTTTTTTTTTTTTM
MTTTTPTTTTTTTTTTTTTTTTTTTTTTRTTM
MTTTTTTTTTTTTTTTTTRTTTTTTTTRRTTM
MTTTTTTTTTTTRTTTTTTTTTTTTTTTRTTM
MTTTTTTTRTTTTTTTTTTTTTTTTTTTRTTM
MTTTTTTTTTTTTTRTTTTTTTTTTTTTTTTM
MTTTTTTTTTTTTTTTTTTTTTTTTTTTTTTM
MTTTTTTTTTTTTTTTTTTTTTTTTTTTTTTM
MTTTTTTTTTTTTTTTTTTTTTTTTTTTTTTM
MTTTTTTTDTTTTTTTTTTTTTTTTTTTTTTM
MTTTTTTTTTTTTTTTTTTVTTTTTTTTTTTM
MTTTTTTTTTTTTTTTTTTTTTTTTTTTTTTM
MTTTTTTTTTTTTTTDTTTTTTTTTTTTTTTM
MTTTTTTTTTTTTTTTTTTTTTTTTTTTTTTM
MMMMMMMMMMMMMMMMMMMMMMMMMMMMMMMM